################################
#...............##.............#
#...............##.............#
#...............##.............#
#...............##.............#
#...............##.............#
#...............##.............#
#...............##.............#
#...............##.............#
#...............##.............#
#...............##.............#
#...............##.............#
#...............##.............#
#...............##.............#
#...............##.............#
#...............##.............#
#...............##.............#
#...............##.............#
#...............##.............#
#..ND@.o.o.*....##....C....E...#
################################
################################
