################################
#...............##.............#
#...............##.............#
#...............##.............#
#...............##.............#
#...............##.............#
#...............##.............#
#...............##.............#
#...............##.............#
#...............##.............#
#...............##.............#
#...............##.............#
#...............##.............#
#..N.@...*...D..##....C....E...#
#..............................#
################################
