################################
#..........................##..#
#..........................##..#
#..........................##..#
#..........................##..#
#..........................##..#
#..........................##..#
#..........................##..#
#..........................##..#
#..........................##..#
#..........................##..#
#..........................##..#
#..........................##..#
#..........................##..#
#..........................##..#
#..........................##..#
#..........................##..#
#..........................##..#
#N.D.@..o.....=PG......*.......#
#............#####.........##..#
################################
################################
