####################################
#..................................#
#..................................#
#..................................#
#..................................#
#..................................#
#..................................#
#..................................#
#..................................#
#..................................#
#..................................#
#..................................#
#..................................#
#..............................G...#
#..............................#...#
#..............................#...#
#...........#kk##............=.#...#
#............................#.#...#
#..@..o..F........N.D...DN.....#...#
#..............................#...#
####################################
####################################
