################################################
#..............................................#
#..............................................#
#..............................................#
#..............................................#
#..............................................#
#..............................................#
#..........................................E...#
#.........................................######
#..............................................#
#..............................................#
#..............................................#
#..............................................#
#..@...........................................#
#.........C...................^^^^^............#
#.......#####...o..............................#
#..............................................#
#..............................................#
################################################
################################################
