########################
#......................#
#......................#
#......................#
#..........CE..........#
########################
#......................#
#......................#
#......................#
#^^^^^^^^^^^^^^^^^^^^^^#
#......................#
#......................#
#......................#
#^^^^^^^^^^^^^^^^^^^^^^#
#......................#
#......................#
#......................#
#^^^^^^^^^^^^^^^^^^^^^^#
#......................#
#......................#
#......................#
#^^^^^^^^^^^^^^^^^^^^^^#
#......................#
#......................#
#......................#
#^^^^^^^^^^^^^^^^^^^^^^#
#......................#
#..@...................#
########################
########################
