################################
#...............##.........##..#
#...............##.........##..#
#...............##.........##..#
#...............##.........##..#
#...............##.........##..#
#...............##.........##..#
#...............##.........##..#
#...............##.........##..#
#...............##.........##..#
#...............##.........##..#
#...............##.........##..#
#...............##.........##..#
#...............##.........##..#
#...............##.........##..#
#...............##.........##..#
#..........................##..#
#..........................##..#
#N.D.@..o.....=PG......*...##..#
#............#####.........##..#
################################
################################
