################################################
#..............................................#
#..............................................#
#..............................................#
#..............................................#
#..............................................#
#..............................................#
#..........................................E...#
#.........................................######
#..............................................#
#..............................................#
#..............................................#
#..............................................#
#.........C....................................#
#..@..........................^^^^^............#
#.......#####...o..............................#
#.....F........................................#
#..............................................#
################################################
################################################
